[console_scripts]
simtools-calculate-incident-angles = simtools.applications.calculate_incident_angles:main
simtools-convert-all-model-parameters-from-simtel = simtools.applications.convert_all_model_parameters_from_simtel:main
simtools-convert-geo-coordinates-of-array-elements = simtools.applications.convert_geo_coordinates_of_array_elements:main
simtools-convert-model-parameter-from-simtel = simtools.applications.convert_model_parameter_from_simtel:main
simtools-db-add-file-to-db = simtools.applications.db_add_file_to_db:main
simtools-db-add-simulation-model-from-repository-to-db = simtools.applications.db_add_simulation_model_from_repository_to_db:main
simtools-db-add-value-from-json-to-db = simtools.applications.db_add_value_from_json_to_db:main
simtools-db-generate-compound-indexes = simtools.applications.db_generate_compound_indexes:main
simtools-db-get-array-layouts-from-db = simtools.applications.db_get_array_layouts_from_db:main
simtools-db-get-file-from-db = simtools.applications.db_get_file_from_db:main
simtools-db-get-parameter-from-db = simtools.applications.db_get_parameter_from_db:main
simtools-db-inspect-databases = simtools.applications.db_inspect_databases:main
simtools-db-upload-model-repository = simtools.applications.db_upload_model_repository:main
simtools-derive-ctao-array-layouts = simtools.applications.derive_ctao_array_layouts:main
simtools-derive-mirror-rnda = simtools.applications.derive_mirror_rnda:main
simtools-derive-photon-electron-spectrum = simtools.applications.derive_photon_electron_spectrum:main
simtools-derive-psf-parameters = simtools.applications.derive_psf_parameters:main
simtools-derive-trigger-rates = simtools.applications.derive_trigger_rates:main
simtools-docs-produce-array-element-report = simtools.applications.docs_produce_array_element_report:main
simtools-docs-produce-calibration-reports = simtools.applications.docs_produce_calibration_reports:main
simtools-docs-produce-model-parameter-reports = simtools.applications.docs_produce_model_parameter_reports:main
simtools-docs-produce-simulation-configuration-report = simtools.applications.docs_produce_simulation_configuration_report:main
simtools-generate-array-config = simtools.applications.generate_array_config:main
simtools-generate-corsika-histograms = simtools.applications.generate_corsika_histograms:main
simtools-generate-default-metadata = simtools.applications.generate_default_metadata:main
simtools-generate-regular-arrays = simtools.applications.generate_regular_arrays:main
simtools-generate-simtel-event-data = simtools.applications.generate_simtel_event_data:main
simtools-maintain-simulation-model-add-production = simtools.applications.maintain_simulation_model_add_production:main
simtools-maintain-simulation-model-compare-productions = simtools.applications.maintain_simulation_model_compare_productions:main
simtools-maintain-simulation-model-verify-production-tables = simtools.applications.maintain_simulation_model_verify_production_tables:main
simtools-merge-tables = simtools.applications.merge_tables:main
simtools-plot-array-layout = simtools.applications.plot_array_layout:main
simtools-plot-simtel-events = simtools.applications.plot_simtel_events:main
simtools-plot-tabular-data = simtools.applications.plot_tabular_data:main
simtools-plot-tabular-data-for-model-parameter = simtools.applications.plot_tabular_data_for_model_parameter:main
simtools-print-version = simtools.applications.print_version:main
simtools-production-derive-corsika-limits = simtools.applications.production_derive_corsika_limits:main
simtools-production-derive-statistics = simtools.applications.production_derive_statistics:main
simtools-production-generate-grid = simtools.applications.production_generate_grid:main
simtools-production-merge-corsika-limits = simtools.applications.production_merge_corsika_limits:main
simtools-run-application = simtools.applications.run_application:main
simtools-simulate-flasher = simtools.applications.simulate_flasher:main
simtools-simulate-illuminator = simtools.applications.simulate_illuminator:main
simtools-simulate-pedestals = simtools.applications.simulate_pedestals:main
simtools-simulate-prod = simtools.applications.simulate_prod:main
simtools-simulate-prod-htcondor-generator = simtools.applications.simulate_prod_htcondor_generator:main
simtools-submit-array-layouts = simtools.applications.submit_array_layouts:main
simtools-submit-data-from-external = simtools.applications.submit_data_from_external:main
simtools-submit-model-parameter-from-external = simtools.applications.submit_model_parameter_from_external:main
simtools-validate-camera-efficiency = simtools.applications.validate_camera_efficiency:main
simtools-validate-camera-fov = simtools.applications.validate_camera_fov:main
simtools-validate-cumulative-psf = simtools.applications.validate_cumulative_psf:main
simtools-validate-file-using-schema = simtools.applications.validate_file_using_schema:main
simtools-validate-optics = simtools.applications.validate_optics:main
